{  
    "version": 1,  
    "name": "Demo16x16_RLE",  
    "author": "Devin (Deepwiki)",
    "width": 16,  
    "height": 16,  
    "map": [  
        5,5,5,5,5,5,5,5,5,5,5,5,5,5,5,5,  
        5,0,0,0,0,0,0,0,0,0,0,0,0,0,0,5,  
        5,0,1,1,1,0,0,3,3,0,0,1,1,1,0,5,  
        5,0,1,1,1,0,0,3,3,0,0,1,1,1,0,5,  
        5,0,0,0,0,0,0,0,0,0,0,0,0,0,0,5,  
        5,0,0,0,0,0,0,0,0,0,0,0,0,0,0,5,  
        5,0,4,4,4,4,0,0,0,0,4,4,4,4,0,5,  
        5,0,4,4,4,4,0,0,0,0,4,4,4,4,0,5,  
        5,0,0,0,0,0,0,2,2,0,0,0,0,0,0,5,  
        5,0,0,0,0,0,0,2,2,0,0,0,0,0,0,5,  
        5,0,3,3,0,0,0,0,0,0,0,0,3,3,0,5,  
        5,0,3,3,0,0,0,0,0,0,0,0,3,3,0,5,  
        5,0,0,0,0,1,1,1,1,1,0,0,0,0,0,5,  
        5,0,0,0,0,1,1,1,1,1,0,0,0,0,0,5,  
        5,0,0,0,0,0,0,0,0,0,0,0,0,0,0,5,  
        5,5,5,5,5,5,5,5,5,5,5,5,5,5,5,5  
    ], 
    "tilemap": "",  
    "tilemap_tiles": {},  
    "units": [],  
    "objects": []  
}