{
    "version": 1,
    "name": "Island Outpost",
    "author": "Gemini",
    "width": 12,
    "height": 12,
    "map": [
        1, 1, 1, 1, 1, 1, 1, 1, 1, 1, 1, 1,
        1, 1, 1, 0, 0, 0, 0, 0, 1, 1, 1, 1,
        1, 1, 0, 0, 3, 3, 3, 0, 0, 1, 1, 1,
        1, 0, 0, 3, 5, 5, 5, 3, 0, 0, 1, 1,
        1, 0, 3, 5, 0, 0, 0, 5, 3, 0, 1, 1,
        1, 0, 3, 5, 0, 2, 0, 5, 3, 0, 1, 1,
        1, 0, 3, 0, 0, 0, 0, 5, 3, 0, 1, 1,
        1, 0, 4, 4, 4, 0, 5, 5, 3, 0, 1, 1,
        1, 0, 0, 0, 4, 0, 3, 3, 0, 0, 1, 1,
        1, 1, 0, 0, 4, 0, 0, 0, 0, 1, 1, 1,
        1, 1, 1, 0, 4, 0, 0, 1, 1, 1, 1, 1,
        1, 1, 1, 1, 1, 1, 1, 1, 1, 1, 1, 1
    ],
    "tilemap": "",
    "tilemap_tiles": {},
    "units": [],
    "objects": []
}