{
  "version": 1,
  "name": "River Outpost",
  "author": "ChatGPT",
  "comment": "Custom example map: river + bridge + lava pit + rough/cover patches.",
  "width": 12,
  "height": 12,
  "map": [
    5,5,5,5,5,5,5,5,5,5,5,5,
    5,0,0,0,0,1,1,0,0,0,0,5,
    5,0,4,4,0,1,1,0,3,3,0,5,
    5,0,4,4,0,1,1,0,3,3,0,5,
    5,0,0,0,0,1,1,0,0,0,0,5,
    5,0,0,2,2,3,3,0,0,0,0,5,
    5,0,0,2,0,1,1,0,0,0,0,5,
    5,0,0,2,0,1,1,0,0,0,0,5,
    5,0,0,2,2,1,1,0,0,0,0,5,
    5,0,0,0,0,1,1,0,4,4,0,5,
    5,0,0,0,0,1,1,0,4,4,0,5,
    5,5,5,5,5,5,5,5,5,5,5,5
  ],
  "tilemap": "",
  "tilemap_tiles": {},
  "units": [],
  "objects": []
}