{
  "version": 1,
  "name": "Windsurf Test",
  "author": "Windsurf",
  "width": 10,
  "height": 10,
  "map": [
    2, 2, 2, 2, 2, 2, 2, 2, 2, 2,
    2, 0, 0, 0, 0, 0, 0, 0, 0, 2,
    2, 0, 1, 1, 1, 1, 1, 1, 0, 2,
    2, 0, 1, 0, 0, 0, 0, 1, 0, 2,
    2, 0, 1, 0, 2, 2, 0, 1, 0, 2,
    2, 0, 1, 0, 2, 2, 0, 1, 0, 2,
    2, 0, 1, 0, 0, 0, 0, 1, 0, 2,
    2, 0, 1, 1, 1, 1, 1, 1, 0, 2,
    2, 0, 0, 0, 0, 0, 0, 0, 0, 2,
    2, 2, 2, 2, 2, 2, 2, 2, 2, 2
  ]
}